NO textures/512_cobblestone.xpm
SO ./textures/512_crafting_table_front.xpm
WE textures/512_grass_block_side.xpm
EA textures/512_tnt_side.xpm


C 150,200,50
F 20,170,200

    11111111111111111111111
  11110000000000000000000011
 11011100001111111101111000111
 10000000010000000001000000011
 10000000010000000001000000011
 10000000010000000001000000011
 10000000011111111111000000011
 100000000000E0010100000011101      111
 10110001111001110001111000111      101
 10000000000000000000000010001      111
 100000000000000000000000000011
11000000000000000000000000000011
10000000000000000000000000000001
10000000000000000000000000000001
11000000000000000000000000000011
 100000000000000000000000000011
 10000000111111111110000000001
 10000000100000000010000000001
 11000000111111111110000000001
 10000000000000000000000000001
 10000000000000000000000000001
 10000000000000000000000000001
 11111111111111111111111111111